BBBBBBBBBBBBBBBBBBBBBBBBBBBBBB
B                            B
B             J              B
BXXXXXXXXXXX XXXXXXXXXXXXXXXXB
BXXXXXXXXXXX XXXXXXXXXXXXXXSXB
BXXXXSSSXXX  XXXXXXXCCXXXXSSXB
BXXXXXSSXXXXSSSXXXXGSSXX XXXXB
BXXXXXXXXXXXCXXXXXXSSXXX XXXXB
BXXXXXX  XXXXSCXXXXXXXXX XXXXB
BXXXXX   XXXXUGXXXXXXXXX XXXXB
BXXXXXXXXXXXXXXXXXXXXX    XXXB
BXXXXXGSCXXXXXXCXXXXXXXXXSXXXB
BXXXXSGCUXXXXXXXSXCXXXXGSSXXXB
BXXXXXXXXGGUXXXSSSCXXXXXXXCXXB
BXXGXXXSSSSGXXXXXXXXXXXSSXXXXB
BXXXXXXXXXUCXXX XXXUSXXXXSXXXB
BXXXXUUXX       XXXXXXXXXSSCXB
BXXXSTTSX XXXXXXXXXSTSXXXXXXXB
BXXXXXXGXXXXXXCUXXXXXXXXXXXXXB
BBBBBBBBBBBBBBBBBBBBBBBBBBBBBB