BBBBBBBBBBBBBBBBBBBBBBBBBBBBBB
B                            B
B       J                    B
BXXXXX XXXXXXXXXXXXXXXXXXXXXXB
BXXXXX XXXXXXXCXXXXXXXXXSXXXXB
BXXXXX    XXXXSSXXXXXXXCGSXXXB
BXXXXXSSXXXXXX XXXXXXXCSSXXXXB
BXXSXXXXXXXXXX XXXXXXXGXXXXXXB
BXXSXXUXXXXX       XXXXXXXXXXB
BXXXSGXXXXXXXXXXSCXXXXXXX XXXB
BXXTXXXXXXXXUXXXUSGXXXXXX XXXB
BXXXXXGSCXXXXXXCXSSXXXXXX XXXB
BXXXXSGCUXXXXXXXSXCXXXXXX SSXB
BXXXXXXXXGGXXXXSSSCXXXX    XXB
BXXGXX   XXUXXXXXXXXXXXSSCSXXB
BXX      XUGSSXXSXXUSXXXXSXXXB
BXXXXUU  XXGTGXXXXXSXXXXXSSCXB
BXXXSTSXXXXXXXXXXXXUGCGXXXXXXB
BXXXXGCSXXXXXSTTUUXXXXXXXXXXXB
BBBBBBBBBBBBBBBBBBBBBBBBBBBBBB